NO sources/textures/beige_wall.png
SO sources/textures/dark_wall.png
WE sources/textures/gray_wall.png
EA sources/textures/yellow_wall.png
F 255,255,000                  
C 001,001,000             

   11111111111
   10001 10001
11110001 10001
10000000100001
10000000000001
111111111000011111
   100000000S00001
   111111111111111