F 255,176,00
C 0,255,0

SO  sources/textures/yellow_wall.png
EA ./sources/textures/beige_wall.png
WE ./sources/textures/dark_wall.png
NO sources/textures/gray_wall.png

			1111111111111111111
			1000000000000000001
			10001000111100011111111
			10001001    10000000001
			10001000111100010011111
			1D1111111111D111111
			1000010000000000001
			1000010000000000001
			1000011111000000001
			1000000001000000001
			100S000001000000001
			1000000001000000001
			1000000001000000001
			100000000D000000001
			1000000001000000001
			1000000011100000001           
			1000000010000000001
			1000000010000000001
			1111111111111111111
