F 255,176,00
C 0,255,0

SO  sources/textures/yellow_wall.png
EA ./sources/textures/beige_wall.png
WE ./sources/textures/dark_wall.png
NO          sources/textures/gray_wall.png

1111111111111111111
1000000000000000001
100000111100011111111
100001    10000000001
100000111100010011111
1D111111D1110111111
1000010000000000001
1000010000000000001
1000011111000000001
1000000010000000001
D00S000001000000001
1000000001000000001
1000000001000000001
100000000D000000001
100D000001000000001
1000000011100000001           
1000000010000000001
1000000010000000001
1111111111111111111
