SO ./path_to_the_north_texture.png
NO ./path_to_the_south_texture.png
WE ./path_to_the_west_texture.png
EA ./path_to_the_east_texture.png
F 255,255,000                                                
C 001,001,000 
1111111111111111111
1000000000000000001
1000000000000100001
1000001001000001001
1000100000010000001
1010000010000100101
1000000000000000001
1000010000000000001
1000010000000000001
1000000000000000001
100000S000000000001
1000000000000000001
1111111111111111111