EA ./sources/textures/beige_wall.png
SO sources/textures/yellow_wall.png
NO sources/textures/gray_wall.png
WE ./sources/textures/dark_wall.png

F 78,176,29
C 255,255,0

1111111111111111111
1000000000000000001
1000100000000001111
100010000011D101001
1000100000100101001
111111111111D111111
1000010000000000001
1000010000000000001
1000011111000000001
1000000001000000001
100000S001000000001
1000000001000000001
1000000001000000001
100000000D000000001
1000000001000000001
1000000011100000001
1000000010000000001
1000000010000000001
1111111111111111111