SO sources/textures/yellow_wall.png
NO sources/textures/gray_wall.png
WE sources/textures/dark_wall.png
EA sources/textures/beige_wall.png

F 000,255,000 
C 000,000,255                                     

1111111111111111111
1000000000000000001
1000100000000001111
1000100000000001001
1000100000000001001
1111111110000111111
1000010000000000001
1000010000000000001
1000010000000000001
1000000000000000001
100000S000000000001
1000000000000000001
1000000000000000001
1000000000000000001
1000000000000000001
1000000000000000001
1000000000000000001
1000000000000000001
1000000000000000001
1000000000000000001
1000000000000000001
1111111111111111111