C 074,035,255
F 200,150,000

1111111
10S0001
1111111